NO ./assets/1.xpm
SO ./assets/2.xpm
EA ./assets/3.xpm
WE ./assets/4.xpm

C 29,199,225
F 125,147,125

111111111111111
10S00000000001
100000000000001111111111111111
1000010000000000000100000001
10000D0000000000000000000001
10000100000000000000010001111
10000000001011111111110001
100000000000001      10001
100000000000001      10001
100000000000001      10001
10000000000000111111111011111111111
10000000000000100000000000000000001
100000000000001000001001010000000011111
110000000000001001110000000000110010001
111111111111111001000000000000010010001
              1111111111111111111111111